font.xpr	xboxtest\Media\DolphinClassic\Media
Resource.xpr	xboxtest\Media\DolphinClassic\Media
Arial_16.abc	xboxtest\Media\DolphinClassic\Media\fonts
Arial_16.tga	xboxtest\Media\DolphinClassic\Media\fonts
dolphin1.x	xboxtest\Media\DolphinClassic\Media\models
dolphin1.xbg	xboxtest\Media\DolphinClassic\Media\models
dolphin2.x	xboxtest\Media\DolphinClassic\Media\models
dolphin2.xbg	xboxtest\Media\DolphinClassic\Media\models
dolphin3.x	xboxtest\Media\DolphinClassic\Media\models
dolphin3.xbg	xboxtest\Media\DolphinClassic\Media\models
seafloor.x	xboxtest\Media\DolphinClassic\Media\models
seafloor.xbg	xboxtest\Media\DolphinClassic\Media\models
dolphin.psh	xboxtest\Media\DolphinClassic\Media\shaders
dolphin.vsh	xboxtest\Media\DolphinClassic\Media\shaders
dolphin.xpu	xboxtest\Media\DolphinClassic\Media\shaders
dolphin.xvu	xboxtest\Media\DolphinClassic\Media\shaders
seafloor.vsh	xboxtest\Media\DolphinClassic\Media\shaders
seafloor.xvu	xboxtest\Media\DolphinClassic\Media\shaders
caust00.tga	xboxtest\Media\DolphinClassic\Media\textures
caust01.tga	xboxtest\Media\DolphinClassic\Media\textures	
caust02.tga	xboxtest\Media\DolphinClassic\Media\textures
caust03.tga	xboxtest\Media\DolphinClassic\Media\textures
caust04.tga	xboxtest\Media\DolphinClassic\Media\textures
caust05.tga	xboxtest\Media\DolphinClassic\Media\textures
caust06.tga	xboxtest\Media\DolphinClassic\Media\textures
caust07.tga	xboxtest\Media\DolphinClassic\Media\textures
caust08.tga	xboxtest\Media\DolphinClassic\Media\textures
caust09.tga	xboxtest\Media\DolphinClassic\Media\textures
caust10.tga	xboxtest\Media\DolphinClassic\Media\textures
caust11.tga	xboxtest\Media\DolphinClassic\Media\textures
caust12.tga	xboxtest\Media\DolphinClassic\Media\textures
caust13.tga	xboxtest\Media\DolphinClassic\Media\textures
caust14.tga	xboxtest\Media\DolphinClassic\Media\textures
caust15.tga	xboxtest\Media\DolphinClassic\Media\textures
caust16.tga	xboxtest\Media\DolphinClassic\Media\textures
caust17.tga	xboxtest\Media\DolphinClassic\Media\textures
caust18.tga	xboxtest\Media\DolphinClassic\Media\textures
caust19.tga	xboxtest\Media\DolphinClassic\Media\textures
caust20.tga	xboxtest\Media\DolphinClassic\Media\textures
caust21.tga	xboxtest\Media\DolphinClassic\Media\textures
caust22.tga	xboxtest\Media\DolphinClassic\Media\textures
caust23.tga	xboxtest\Media\DolphinClassic\Media\textures
caust24.tga	xboxtest\Media\DolphinClassic\Media\textures
caust25.tga	xboxtest\Media\DolphinClassic\Media\textures
caust26.tga	xboxtest\Media\DolphinClassic\Media\textures
caust27.tga	xboxtest\Media\DolphinClassic\Media\textures
caust28.tga	xboxtest\Media\DolphinClassic\Media\textures
caust29.tga	xboxtest\Media\DolphinClassic\Media\textures
caust30.tga	xboxtest\Media\DolphinClassic\Media\textures
caust31.tga	xboxtest\Media\DolphinClassic\Media\textures
dolphin.bmp	xboxtest\Media\DolphinClassic\Media\textures
seafloor.bmp	xboxtest\Media\DolphinClassic\Media\textures
